#############
#s  #     # #
### # ### # #
#     # # # ######
####### # #     f#
#       # # ######
# ####### # #
#           #
#############