#############
#s        #f#
### # ### # #
#       # # #
####### # # #
#       # # #
# ####### # #
#           #
#############